 P                 P    P    
            P          P     
    P         P   P    B     
          P          I       
 B        P     P            
  B  P    B           P      
                 P     P     
   P                  P      
    B   I  P     P   B       
        B     P      P       
  P          B      P        
             P        B      
