 P                           
            P          P     
    P                  B     
          P          I       
                             
     I    B                  
              I  P           
   P                  P      
        I  P         B       
              P      P       
  P                 P        
             P        B      
